XXXXXXXXXXXXXXXXXXXXXXXXXXXXXXXXXXXXXXXXXDGXXXXXXXXXXXXXXXXXXXXXXXXXXXXXXXXXXXXXX
XXXXXXXXXXXXXXXXXXXXXXXXXXXXXXXXXXXXXXXXXDGXXXXXXXXXXXXXXXXXXXXXXXXXXXXXXXXXXXXXX
XXXXXXXXXXXXXXXXXXXXXXXXXXXXXXXXXXXXXXXXXDGXXXXXXXXXXXXXXXXXXXXXXXXXXXXXXXXXXXXXX
XXXXXXXXXXXXXXXXXXXXXXXXXXXGXXXXXXXXXXXXXDGXXXXXXXXXXXXXXXXXXXXXXXXXXXXXXXXXXXXXX
XXXXXXXXXXXXXXXXXXXXXXXGGGGGGGXXXXXXXXXXXDGXXXXXXXXXXXXXXXXXXXXXXXXXXXXXXXXXXXXXX
XXXXXXXXXXXXXXXXXXXXXGGGGGGGGGBXXXXXXXXXXDGXXXXXXXXXXXXXXXXXXXXXXXXXXXXXXXXXXXXXX
XXXXXXXXXXXXXXXXXXXXXBBGGGGGGGGXXXXXXXXXXDGXXXXBBPGGGGFFXXXXXXXXXXXXXXXXXXXXXXXXX
XXXXXGGGFFFGGGGGXXXXXGGGGGGGGGGGBBBBBBBBGGGGGGGGGGGGGGFFXXXXXXXXXXXXBBFFFFBBXXXXX
XXXXXGGGGGGGGGGXXXXXXDDDDDDGGGGGGGGGGGGGGGGGGGGGGGGGGGGGXXBBXXXXXXXXBBFFFFBXXXXXX
XXXXXGGGGGGGGGGXXXXXXDDDDGGGGGGGGGGGGGGGGGGGGGGGGGGGGGGGGGGGGGGGGGGGGGGGGGGBBBGXX
XXXXXXXXXXXXXXXXXXXXXDDDDGGGGGGGGGGGGGGGGGGGGGGGBBGGGGGGGGGGGGGGGGGGGGGGGGGGGGBXX
XXXXXXXXXXXXXXXXXXXXDDDDDDDDDDDDDDDDDDDDDGGGGGGGGGGGGGBGGGGGFFFFFFFFFGGGGGGGGGGXX
XXXXXXXXXXXXXXXXXXXDDDDDDDDDDDDDDDDDDDDDDDGGGGGBGGGGGGGGGGGGFFFFFFFFFGGGGGGGGGGXX
XXXXXXXXXXXXXXXXXXXDDDDDDDDDDDDDDDDDDDDDDDGGGGGGGGGBBGGGGGGGFFFFFFFFFGGGGGGGGGGXX
XXXXXXXXXXXXXXXXXXXDDDDDDDDDDDDDDDDDDDDDDDDDDDDDDDDDDDDGGGGGFFFFFFFFFGGGFFGGGGGGG
XXXXXXXXXXXXXXXXXXXDDDDDDDDDDDDDDDDDDDDDDDDDDDDDDDDDDDDGGGGGFFFFFFFFFFGGDPGGGGGGG
XXXXXXXXXXXXXXXXXXXDDDDDDDDDDDDDDDDDDDDDDDDDDDDDDDDDDDDGGGGGGGGGGGGGGGGDDPPPPPPPP
XXXXXXXXXXXXXXXXXXDDDDDDDDDDDDDDDDDDDDDDDDDDDDDDDDDDDDDGGGGGDDDDDDDDDDDDDGGGGGGGG
XXXXXXXXXXXXXXXXXDDDDDDDDDDDDDDDDDDDDDDDDDDDDDDDDDDDDDDGGGGDDDDDDDDDDDDDDGGGGGXXX
XXXXXXXXXXXXXXXXXBDDDDDDDDDDDDDDDDDDDDDDDDDDDDDDDDDDDDDGGGGDDDDDDDDDDDDDGGGGGGGXX
XXXXXXXXXXXXXXXBBDDDDDDDDDDDDDDDDDDDDDDDDDDDDDDDDDDDDDDGGGGDDDDDDDDDDDDGGGGGGGGXX
XXXXXXXXXDDBBBDDDDDDDDDDDDDDDDDDDDDDDDDDDDDDDDDDDDDDDDDGGGGDDDDDDDDDDDDGGGGGGGGXX
XXXXXXXDDDDDDDDDDDDDDDDDDDDDDDDDDDDDDDDDDDDDDDDDDDDDDDDGGGDDDDDDDDDDDDDGGGGGGGGXX
XXXXXDDDDDDDDDDDDDDDDDDDDDDDDDDDDDDDDDDDDDDDDDDDDDDDDDDGGGDDDDDDDDDDDDDGGGGGGGGXX
XXXXXDDDDDDDDDDDDDDDDDDDDDDDDDDDDDDDDDDDDDDDDDDDDDDDDDDGGGDDDDDDDDDDDDDGGGGGGGGXX
XXXXXDDDDDDDDDDDDDDDDDDDDDDDDDDDDDDDDDDDDDDDDDDDDDDDDDDGGGDDDDDDDDDDDDDGGGGGGGGXX
XXXXXDDDDDDDDDDDDDDDDDDDDDDDDDDDDDDDDDDDDDDDDDDDDDDDDDDGGGDDDDDDDDDDDDDDGGGGGGGXX
XXXXXDDDDDDDDDDDDDDDDDDDDDDDDDDDDDDDDDDDDDDDDDDDDDDDDDDGGDDDDDDDDDDDDDDDWWWWWDDXX
XXXXXDDDDDDDDDDDDDDDDDDDDDDDDDDDDDDDDDDDDDDDDDDDDDDDDDDGGDDDDDDDDDDDDDDDWWWWWWDXX
XXXXXXDDDDDDDDDDDDDDDDDDDDDDDDDDDDDDDDDDDDDDDDDDDDDDDDDGDDDDDDDDDDDDDDDDWWWWWWDXX
XXXXXXDDDDDDDDDDDDDDDDDDDDDDDDDDDDDDDDDDDDDDDDDDDDDDDDGGDDDDDDDDDDDDDDDDWWWWWWDXX
XXXXXXDDDDDDDDDDDDDDDDDDDDDDDDDDDDDDDDDDDDDDDDWWWWWWWDDDDDDDDDDDDDDDDDDDWWWWWWDXX
XXXXXXDDDDDDDDDDDDDDDDDDDDDDDDDDDDDDDDDDDDDDDWWWWWWWWWDDDDDDDDDDDDDDDDDDDWWWWWDXX
XXXXXXDDDDDDDDDDDDDDDDDDDDDDDDDDDDDDDDDDDDDDWWWWWWWWWWWWDDDDDDDDDDDDDDDDDDDDDDDXX
XXXXXXDDDDDDDDBDDXXXXXXDDDDDDDDDDDDDDDDDDDDWWWWWWWWWWWWWWDDDDDDDDDDDDDDDDDDDDDDXX
XXXXXXDDDDDDDDDDXXXXXXXXDDDDDDDDDDDDDDDDDDDWWWWWWWWWWWWWWWWDDDDDDDDDDDDDDDDDDDDXX
XXXXXXXDDDDDDDDXXXXXXXXXDDDDDDDDDDDDDDDDDDDWWWWWWWWWWWWWWWWDDDDDDDDDDDDDDDXXXXXXX
XXXXXXXDDDDDDDXXXXXXXXXXDDDDDDDDDDDDDDDDDDDWWWWWWWWWWWWWWWWDDDDDDDDDDDDDDDXXXXXXX
XXXXXXXXDXXXXXXXXXXXXXXXDDDDDDDDDDDDDDDDDDWWWWWWWWWWWWWWWWWDDDDDDDDBDDDBDDDDXXXXX
XXXXXXXXXXXXXXXXXXXXXXXXDDDDDDDDDDDDDDDDDDWWWWWWWWWWWWWWWWWDDDDBDDDDDDDDDDDDDDDXX
XXXXXXXXXXXXXXXXXXXXXXXXDDDDDDDDDDDDDDDDDDWWWWWWWWWWWWWWWWDDDDDDDDDDDDDDDDDDDXXXX
XXXXXXXXXXXXXXXXXXXXXXXXDDDDDDDDDDDDDDDDDDDWWWWWWWWWWWWWWWDDDDDDDDWWWWWWDDDDDDDXX
XXXXXXXXXXXXXXXXXXXXXXXXDDDDDDDDDDDDDDDDDDDDWWWWWWWWWWWWWDDDDDDDDWWWWWWWWDDBBDDXX
XXXXXXXXXXXXXXXXXXXXXXXDDDDDDDDDDDDDDDDDDDDDDDDWWWWWWWDDDDDDDDDDWWWWWWWWWWDDDDDXX
XXXXXXXXXXXXXXXXXXXXDDDDDDDDDDDDDDDDDDDDDDDDDDDDDDDDDDDDDDDDDDDDWWWWWWWWWWDDDDDXX
XXXXXXXXXXXXXXXXXXDDBBDDDDDDDDDDDDDDDDDDDDDDDDDDDDDDDDDDDDDDDDDDWWWWWWWWWWDDDDDXX
XXXXXXXXDDDDDBBBDDBDDDDDDDDDDDDDDDDDDDDDDDDDDDDDDDDDDDDDDDDDDDDWWWWWWWWWWWDDDDDXX
XXXXDDBBDDDDDDDDDDDDDDDDDDDDDDDDDDDDDDDDDDDDDDDDDDDDDDDDDDDDDDDWWWWWWWWWWDDDDDDXX
XXXXBBDDDDDDDDDDDDDDDDDDDDDDDDDDDDDDDDDDDDDDDDDDDDDDDDDDDDDDDDDWWWWWWWWWDDDDDDDXX
XXXXDDDDDDDDDDDDDDDDDDDDDDDDDDDDDDDDDDDDDDDDDDDDDDDDDDDDDDDDDDDDWWWWWWDDDDDDDDDXX
XXXXDBDDDDDDDDDDDDDDDDDDDDDDDDDDDDDDDDDDDDDDDDDDDDDDDDDDDDDDDDDDDWWWWDDDDDDDDDDXX
XXXXDDDDDDDDDDDDDDDDDDDDDDDDDDDDDDDDDDDDDDDDDDDDDWWWDDDDDDDDDDDDDDDDDDDDDDDDDDDXX
XXXXXDDDDDDDDDDDDDDDDDDDDDDDDDDDDDDDDDDDDDDDWWWWWWWWWDDDDDDDDDDDDDDDDDDDDDDDDDDXX
XXXXXDDDDDDDDDDDDDDDDDDDDDDDDDDDDDDDDDDDDDDWWWWWWWWWWDDDDDDDDDDDDDDDDDDDDDDDDDDXX
XXXXXXDDDDDDDDDDDDDDDDDDDDDDDDDDDDDDDDDDDDDWWWWWWWWWWDDDDDDDDDDDDDDDDDDDDDDXXXXXX
XXXXXXDDDDDDDDDDDDDDDDDDDDDDDDDDDDDDDDDDDDDWWWWWWWWWDDDDDDDDDDDDDDDDDDDDDDXXXXXXX
XXXXXXXDDDDDDDDDDDDDDDDDDDDDDDDDDDDDDDDDDDDDWWWWWWWDDDDDDDDDDDDDDDDDDDDDDXXXXXXXX
XXXXXXXDDDDDDDDDDDDDDDDDDDDDDDDDDDDDDDDDDDDDDDDDDDDDDDDDDDDDDDDDDDDDDXXXXXXXXXXXX
XXXXXXXXXXXXXXXXXDDDDDDDDDDDDDDDDDDDDDDDDDDDDDDDDDDDDDDDDDDDDDDDDDDXXXXXXXXXXXXXX
XXXXXXXXXXXXXXXXXXXXXXDDDDDDDDDDDDDDDDDDDDDDDDDDDDDDDDDDDDDDDDDDDDDXXXXXXXXXXXXXX
XXXXXXXXXXXXXXXXXXXXXXXXXXXXXXXXXXXXXXXXDDDDXXXXXXXXXXXXXXXXXXXXXXXXXXXXXXXXXXXXX
XXXXXXXXXXXXXXXXXXXXXXXXXXXXXXXXXXXXXXXXXDDXXXXXXXXXXXXXXXXXXXXXXXXXXXXXXXXXXXXXX
XXXXXXXXXXXXXXXXXXXXXXXXXXXXXXXXXXXXXXXXXDDXXXXXXXXXXXXXXXXXXXXXXXXXXXXXXXXXXXXXX
XXXXXXXXXXXXXXXXXXXXXXXXXXXXXXXXXXXXXXXXXDDXXXXXXXXXXXXXXXXXXXXXXXXXXXXXXXXXXXXXX
XXXXXXXXXXXXXXXXXXXXXXXXXXXXXXXXXXXXXXXXXXXXXXXXXXXXXXXXXXXXXXXXXXXXXXXXXXXXXXXXX
