XXXXXXXXXXXXXXXXXXXXXXXXXXXXXXXXXXXXXDGXXXXXXXXXXXXXXXXXXXXXXXXXXXXXXXXXXXXXX
XXXXXXXXXXXXXXXXXXXXXXXXXXXXXXXXXXXXXDGXXXXXXXXXXXXXXXXXXXXXXXXXXXXXXXXXXXXXX
XXXXXXXXXXXXXXXXXXXXXXXXXXXXXXXXXXXXXDGXXXXXXXXXXXXXXXXXXXXXXXXXXXXXXXXXXXXXX
XXXXXXXXXXXXXXXXXXXXXXXXXXXXXXXXXXXXXDGXXXXXXXXXXXXXXXXXXXXXXXXXXXXXXXXXXXXXX
XXXXXXXXXXXXXXXXXXXXXXXXXXXXXXXXXXXXXDGXXXXXXXXXXXXXXXXXXXXXXXXXXXXXXXXXXXXXX
XXXXXXXXXXXXXXXXXXXXXXXXXXXXXXXXXXXXXDGXXXXXXXXXXXXXXXXXXXXXXXXXXXXXXXXXXXXXX
XXXXXXXXXXXXXXXXXXXXXXXXXXXXXXXXXXXXXDGXXXXGDPDDDDFFXXXXXXXXXXXXXXXXXXXXXXXXX
XXXXGGGGFFFGGGGGGGGGGGGGGGGGGGGGGGGGGDGGGGGDDDDDDDFFXXXXXXXXXXXXXXFFFFXXXXXXX
XXXXDDDDDDDDDDDDDDDDDDDDDDDDDDDDDDDDDDDDDDDDDDDDDDDGXXXXXXXXXXXXXXFFFFXXXXXXX
XXGGDDDDDDDDDDDDDDDDDDDDDGGGGGGGDDDDDDDDDDDDDDDDDDDGGGGGGGGGGGGGGGBBBBGBBBBXX
XGGDDDDDDDDDDDDDDDDDDDDDDGGGGGGGDDDDDDDDDDDDDDDDDDDDGGGGGGGGGGGGGGBBBBGGGGBXX
XGDDDDDDDDDDDDDDDDDDDDDDDGGGGGGGDDDDDDDDDDDDDDDDDDDDDGGGFFFFFFFFFGBBBBGGGGGXX
XDDDDDDDDDDDDDDDDDDDDDDDDGGGGGGGDDDDDDDDDDDDDDDDDDDDDDGGFFFFFFFFFGBBBBGGGGGXX
XDDDDDDDDDDDDDDDDDDDDDDDDDGGGGGGDDDDDDDDDDDDDDDDDDDDDDDGFFFFFFFFFGGGBBGGGGGXX
XDDDDDDDDDDDDDDDDDDDDDDDDDDGGGGGDDDDDDDDDDDDDDDDDDDDDDDGFFFFFFFFFGGGFFGGGGGGG
XDDDDDDDDDDDDDDDDDDDDDDDDDDDDDDDDDDDDDDDDDDDDDDDDDDDDDDGFFFFFFFFFFGGDPGGGGGGG
XDDDDDDDDDDDDDDDDDDDDDDDDDDDDDDDDDDDDDDDDDDDDDDDDDDDDDDGGGGGGGGGGGGDDPPPPPPPP
XDDDDDDDDDDDDDDDDDDDDDDDDDDDDDDDDDDDDDDDDDDDDDDDDDDDDDDDDDDDDDDDDDDDDDDDDDDDG
XDDDDDDDDDDDDDDDDDDDDDDDDDDDDDDDDDDDDDDDDDDDDDDDDDDDDDDDDDDDDDDDDDDDDDDDDDGXX
XDDDDDDDDDDDDDDDDDDDDDDDDDDDDDDDDDDDDDDDDDDDDDDDDDDDDDDDDDDDDDDDDDDDDDDDDDGXX
XDDDDDDDDDDDDDDDDDDDDDDDDDDDDDDDDDDDDDDDDDDDDDDDDDDDDDDDDDDDDDDDDDDDDDDDDDGXX
XDDDDDDDDDDDDDDDDDDDDDDDDDDDDDDDDDDDDDDDDDDDDDDDDDDDDDDDDDDDDDDDDDDDDDDDDDGXX
XDDDDDDDDDDDDDDDDDDDDDDDDDDDDDDDDDDDDDDDDDDDDDDDDDDDDDDDDDDDDDDDDDDDDDDDDDGXX
XDDDDDDDDDDDDDDDDDDDDDDDDDDDDDDDDDDDDDDDDDDDDDDDDDDDDDDDDDDDDDDDDDDDDDDDDDGXX
XXXXXDDDDDDDDDDDDDDDDDDDDDDDDDDDDDDDDDDDDDDDDDDDDDDDDDDDDDDDDDDDDDDDDDDDDDGXX
XXXXXDDDDDDDDDDDDDDDDDDDDDDDDDDDDDDDDDDDDDDDDDDDDDDDDDDDDDDDDDDDDDDDDDDDDDGXX
XXXXXDDDDDDDDDDDDDDDDDDDDDDDDDDDDDDDDDDDDDDDDDDDDDDDDDDDDDDDDDDDDDDDDDDDDDGXX
XXXXXDDDDDDDDDDDDDDDDDDDDDDDDDDDDDDDDDDDDDDDDDDDDDDDDDDDDDDDDDDDDDDDDDDDDDGXX
XXXXXDDDDDDDDDDDDDDDDDDDDDDDDDDDDDDDDDDDDDDDDDDDDDDDDDDDDDDDDDDDDDDDWWWWWDGXX
XXXXXDDDDDDDDDDDDDDDDDDDDDDDDDDDDDDDDDDDDDDDDDDDDDDDDDDDDDDDDDDDDDDDWWWWWWGXX
XXXXXDDDDDDDDDDDDDDDDDDDDDDDDDDDDDDDDDDDDDDDDDDDDDDDDDDDDDDDDDDDDDDDWWWWWWGXX
XXXXXDDDDDDDDDDDDDDDDDDDDDDDDDDDDDDDDDDDDDDDDDDDDDDDDDDDDDDDDDDDDDDDWWWWWWGXX
XXXXXDDDDDDDDDDDDDDDDDDDDDDDDDDDDDDDDDDDDDDDDDDDDDDDDDDDDDDDDDDDDDDDWWWWWWGXX
XXXXXDDDDDDDDDDDDDDDDDDDDDDDDDDDDDDDDDDDDDDDDDDDDDDDDDDDDDDDDDDDDDDDDWWWWDGXX
XXXXXDDDDDDDDDDDDDDDDDDDDDDDDDDDDDDDDDDDDDDDDDDDDDDDDDDDDDDDDDDDDDDDDDDDDDGXX
XXXXDDDDDDDDDDDDDDDDDDDDDDDDDDDDDDDDDDDDDDDDDDDDDDDDDDDDDDDDDDDDDDDDDDDDDDGXX
XXXDDDDDDDDDDDDDDDDDDDDDDDDDDDDDDDDDDDDDDDDDDDDDDDDDDDDDDDDDDDDDDDDDDDDDDDGXX
XXDDDDDDDDDDDDDDDDDDDDDDDDDDDDDDDDDDDDDDDDDDDDDDDDDDDDDDDDDDDDDDDDDDDDDDDDGXX
XDDDDDDDDDDDDDDDDDDDDDDDDDDDDDDDDDDDDDDDDDDDDDDDDDDDDDDDDDDDDDDDDDDDDDDDDDGXX
XDDDDDDDDDDDDDDDDDDDDDDDDDDDDDDDDDDDDDDDDDDDDDDDDDDDDDDDDDDDDDDDDDDDDDDDDDGXX
XDDDDDDDDDDDDDDDDDDDDDDDDDDDDDDDDDDDDDDDDDDDDDDDDDDDDDDDDDDDDDDDDDDDDDDDDDGXX
XDDDDDDDDDDDDDDDDDDDDDDDDDDDDDDDDDDDDDDDDDDDDDDDDDDDDDDDDDDDDDDDDDDDDDDDDDGXX
XDDDDDDDDDDDDDDDDDDDDDDDDDDDDDDDDDDDDDDDDDDDDDDDDDDDDDDDDDDDDDDDDDDDDDDDDDGXX
XDDDDDDDDDDDDDDDDDDDDDDDDDDDDDDDDDDDDDDDDDDDDDDDDDDDDDDDDDDDDDDDDDDDDDDDDDGXX
XDDDDDDDDDDDDDDDDDDDDDDDDDDDDDDDDDDDDDDDDDDDDDDDDDDDDDDDDDDDDDDDDDDDDDDDDDGXX
XDDDDDDDDDDDDDDDDDDDDDDDDDDDDDDDDDDDDDDDDDDDDDDDDDDDDDDDDDDDDDDDDDDDDDDDDDGXX
XDDDDDDDDDDDDDDDDDDDDDDDDDDDDDDDDDDDDDDDDDDDDDDDDDDDDDDDDDDDDDDDDDDDDDDDDDGXX
XDDDDDDDDDDDDDDDDDDDDDDDDDDDDDDDDDDDDDDDDDDDDDDDDDDDDDDDDDDDDDDDDDDDDDDDDDGXX
XDDDDDDDDDDDDDDDDDDDDDDDDDDDDDDDDDDDDDDDDDDDDDDDDDDDDDDDDDDDDDDDDDDDDDDDDDGXX
XDDDDDDDDDDDDDDDDDDDDDDDDDDDDDDDDDDDDDDDDDDDDDDDDDDDDDDDDDDDDDDDDDDDDDDDDDGXX
XDDDDDDDDDDDDDDDDDDDDDDDDDDDDDDDDWWWWWWWDDDDDDDDDDDDDDDDDDDDDDDDDDDDDDDDDDGXX
XDDDDDDDDDDDDDDDDDDDDDDDDDDDDDDDWWWWWWWWWDDDDDDDDDDDDDDDDDDDDDDDDDDDDDDDDDGXX
XDDDDDDDDDDDDDDDDDDDDDDDDDDDDDDWWWWWWWWWWWWWDDDDDDDDDDDDDDDDDDDDDDDDDDDDDDGXX
XDDDDDDDDDDDDDDDDDDDDDDDDDDDDDDWWWWWWWWWWWWWWWDDDDDDDDDDDDDDDDDDDDDDDDDDDDGXX
XDDDDDDDDDDDDDDDDDDDDDDDDDDDDDDWWWWWWWWWWWWWWWDDDDDDDDDDDDDDDDDDDDDDDDDDDDGXX
XDDDDDDDDDDDDDDDDDDDDDDDDDDDDDDWWWWWWWWWWWWWWWDDDDDDDDDDDDDDDDDDDDDDDDDDDDGXX
XDDDDDDDDDDDDDDDDDDDDDDDDDDDDDDDWWWWWWWWWWWWWDDDDDDDDDDDDDDDDDDDDDDDDDDDDDGXX
XDDDDDDDDDDDDDDDDDDDDDDDDDDDDDDDWWWWWWWWWWWWDDDDDDDDDDDDDDDDDDDDDDDDDDDXXXXXX
XDDDDDDDDDDDDDDDDDDDDDDDDDDDDDDDDWWWWWWWWWDDDDDDDDDDDDDDDDDDDDDDDDDDDDDXXXXXX
XDDDDDDDDDDDDDDDDDDDDDDDDDDDDDDDDDDWWWWWDDDDDDDDDDDDDDDDDDDDDDDDDDDDDDDXXXXXX
XDDDDDDDDDDDDDDDDDDDDDDDDDDDDDDDDDDDDDDDDDDDDDDDDDDDDDDDDDDDDDDDDDDXXXXXXXXXX
XDDDDDDDDDDDDDDDDDDDDDDDDDDDDDDDDDDDDDDDDDDDDDDDDDDDDDDDDDDDDDDDDDDXXXXXXXXXX
XDDDDDDDDDDDDDDDDDDDDDDDDDDDDDDDDDDDDDDDDDDDDDDDDDDDDDDDDDDDDDDDDDDXXXXXXXXXX
XXXXXXXXXXXXXXXXXXXXXXXXXXXXXXXXXXXXXXDDXXXXXXXXXXXXXXXXXXXXXXXXXXXXXXXXXXXXX
XXXXXXXXXXXXXXXXXXXXXXXXXXXXXXXXXXXXXXXXXXXXXXXXXXXXXXXXXXXXXXXXXXXXXXXXXXXXX
