X X X X X X X X X X X X X X X X X X X X X X X X X X X X X X X X X X X X X D G X X X X X X X X X X X X X X X X X X X X X X X X X X X X X X X X X X X X X X
X X X X X X X X X X X X X X X X X X X X X X X X X X X X X X X X X X X X X D G X X X X X X X X X X X X X X X X X X X X X X X X X X X X X X X X X X X X X X
X X X X X X X X X X X X X X X X X X X X X X X X X X X X X X X X X X X X X D G X X X X X X X X X X X X X X X X X X X X X X X X X X X X X X X X X X X X X X
X X X X X X X X X X X X X X X X X X X X X X X X X X X X X X X X X X X X X D G X X X X X X X X X X X X X X X X X X X X X X X X X X X X X X X X X X X X X X
X X X X X X X X X X X X X X X X X X X X X X X X X X X X X X X X X X X X X D G X X X X X X X X X X X X X X X X X X X X X X X X X X X X X X X X X X X X X X
X X X X X X X X X X X X X X X X X X X X X X X X X X X X X X X X X X X X X D G X X X X X X X X X X X X X X X X X X X X X X X X X X X X X X X X X X X X X X
X X X X X X X X X X X X X X X X X X X X X X X X X X X X X X X X X X X X X D G X X X X G D F D D D D F F X X X X X X X X X X X X X X X X X X X X X X X X X
X X X X G G G G F F F G G G G G G G G G G G G G G G G G G G G G G G G G G D G G G G G D D D D D D D F F X X X X X X X X X X X X X X F F F F X X X X X X X
X X X X D D D D D D D D D D D D D D D D D D D D D D D D D D D D D D D D D D D D D D D D D D D D D D D G X X X X X X X X X X X X X X F F F F X X X X X X X
X X G G D D D D D D D D D D D D D D D D D D D D D G G G G G G G D D D D D D D D D D D D D D D D D D D G G G G G G G G G G G G G G G B B B B G B B B B X X
X G G D D D D D D D D D D D D D D D D D D D D D D G G G G G G G D D D D D D D D D D D D D D D D D D D D G G G G G G G G G G G G G G B B B B G G G G B X X
X G D D D D D D D D D D D D D D D D D D D D D D D G G G G G G G D D D D D D D D D D D D D D D D D D D D D G G G F F F F F F F F F G B B B B G G G G G X X
X D D D D D D D D D D D D D D D D D D D D D D D D G G G G G G G D D D D D D D D D D D D D D D D D D D D D D G G F F F F F F F F F G B B B B G G G G G X X
X D D D D D D D D D D D D D D D D D D D D D D D D D G G G G G G D D D D D D D D D D D D D D D D D D D D D D D G F F F F F F F F F G G G F F G G G G G X X
X D D D D D D D D D D D D D D D D D D D D D D D D D D G G G G G D D D D D D D D D D D D D D D D D D D D D D D G F F F F F F F F F G G G X X G G G G G G G
X D D D D D D D D D D D D D D D D D D D D D D D D D D D D D D D D D D D D D D D D D D D D D D D D D D D D D D G F F F F F F F F F F G G D F G G G G G G G
X D D D D D D D D D D D D D D D D D D D D D D D D D D D D D D D D D D D D D D D D D D D D D D D D D D D D D D G G G G G G G G G G G G D D F F F F F F F X
X D D D D D D D D D D D D D D D D D D D D D D D D D D D D D D D D D D D D D D D D D D D D D D D D D D D D D D D D D D D D D D D D D D D D D D D D D D D G
X D D D D D D D D D D D D D D D D D D D D D D D D D D D D D D D D D D D D D D D D D D D D D D D D D D D D D D D D D D D D D D D D D D D D D D D D D G X X
X D D D D D D D D D D D D D D D D D D D D D D D D D D D D D D D D D D D D D D D D D D D D D D D D D D D D D D D D D D D D D D D D D D D D D D D D D G X X
X D D D D D D D D D D D D D D D D D D D D D D D D D D D D D D D D D D D D D D D D D D D D D D D D D D D D D D D D D D D D D D D D D D D D D D D D D G X X
X D D D D D D D D D D D D D D D D D D D D D D D D D D D D D D D D D D D D D D D D D D D D D D D D D D D D D D D D D D D D D D D D D D D D D D D D D G X X
X D D D D D D D D D D D D D D D D D D D D D D D D D D D D D D D D D D D D D D D D D D D D D D D D D D D D D D D D D D D D D D D D D D D D D D D D D G X X
X D D D D D D D D D D D D D D D D D D D D D D D D D D D D D D D D D D D D D D D D D D D D D D D D D D D D D D D D D D D D D D D D D D D D D D D D D G X X
X X X X X D D D D D D D D D D D D D D D D D D D D D D D D D D D D D D D D D D D D D D D D D D D D D D D D D D D D D D D D D D D D D D D D D D D D D G X X
X X X X X D D D D D D D D D D D D D D D D D D D D D D D D D D D D D D D D D D D D D D D D D D D D D D D D D D D D D D D D D D D D D D D D D D D D D G X X
X X X X X D D D D D D D D D D D D D D D D D D D D D D D D D D D D D D D D D D D D D D D D D D D D D D D D D D D D D D D D D D D D D D D D D D D D D G X X
X X X X X D D D D D D D D D D D D D D D D D D D D D D D D D D D D D D D D D D D D D D D D D D D D D D D D D D D D D D D D D D D D D D D D D D D D D G X X
X X X X X D D D D D D D D D D D D D D D D D D D D D D D D D D D D D D D D D D D D D D D D D D D D D D D D D D D D D D D D D D D D D D D W W W W W D G X X
X X X X X D D D D D D D D D D D D D D D D D D D D D D D D D D D D D D D D D D D D D D D D D D D D D D D D D D D D D D D D D D D D D D D W W W W W W G X X
X X X X X D D D D D D D D D D D D D D D D D D D D D D D D D D D D D D D D D D D D D D D D D D D D D D D D D D D D D D D D D D D D D D D W W W W W W G X X
X X X X X D D D D D D D D D D D D D D D D D D D D D D D D D D D D D D D D D D D D D D D D D D D D D D D D D D D D D D D D D D D D D D D W W W W W W G X X
X X X X X D D D D D D D D D D D D D D D D D D D D D D D D D D D D D D D D D D D D D D D D D D D D D D D D D D D D D D D D D D D D D D D W W W W W W G X X
X X X X X D D D D D D D D D D D D D D D D D D D D D D D D D D D D D D D D D D D D D D D D D D D D D D D D D D D D D D D D D D D D D D D D W W W W D G X X
X X X X X D D D D D D D D D D D D D D D D D D D D D D D D D D D D D D D D D D D D D D D D D D D D D D D D D D D D D D D D D D D D D D D D D D D D D G X X
X X X X D D D D D D D D D D D D D D D D D D D D D D D D D D D D D D D D D D D D D D D D D D D D D D D D D D D D D D D D D D D D D D D D D D D D D D G X X
X X X D D D D D D D D D D D D D D D D D D D D D D D D D D D D D D D D D D D D D D D D D D D D D D D D D D D D D D D D D D D D D D D D D D D D D D D G X X
X X D D D D D D D D D D D D D D D D D D D D D D D D D D D D D D D D D D D D D D D D D D D D D D D D D D D D D D D D D D D D D D D D D D D D D D D D G X X
X D D D D D D D D D D D D D D D D D D D D D D D D D D D D D D D D D D D D D D D D D D D D D D D D D D D D D D D D D D D D D D D D D D D D D D D D D G X X
X D D D D D D D D D D D D D D D D D D D D D D D D D D D D D D D D D D D D D D D D D D D D D D D D D D D D D D D D D D D D D D D D D D D D D D D D D G X X
X D D D D D D D D D D D D D D D D D D D D D D D D D D D D D D D D D D D D D D D D D D D D D D D D D D D D D D D D D D D D D D D D D D D D D D D D D G X X
X D D D D D D D D D D D D D D D D D D D D D D D D D D D D D D D D D D D D D D D D D D D D D D D D D D D D D D D D D D D D D D D D D D D D D D D D D G X X
X D D D D D D D D D D D D D D D D D D D D D D D D D D D D D D D D D D D D D D D D D D D D D D D D D D D D D D D D D D D D D D D D D D D D D D D D D G X X
X D D D D D D D D D D D D D D D D D D D D D D D D D D D D D D D D D D D D D D D D D D D D D D D D D D D D D D D D D D D D D D D D D D D D D D D D D G X X
X D D D D D D D D D D D D D D D D D D D D D D D D D D D D D D D D D D D D D D D D D D D D D D D D D D D D D D D D D D D D D D D D D D D D D D D D D G X X
X D D D D D D D D D D D D D D D D D D D D D D D D D D D D D D D D D D D D D D D D D D D D D D D D D D D D D D D D D D D D D D D D D D D D D D D D D G X X
X D D D D D D D D D D D D D D D D D D D D D D D D D D D D D D D D D D D D D D D D D D D D D D D D D D D D D D D D D D D D D D D D D D D D D D D D D G X X
X D D D D D D D D D D D D D D D D D D D D D D D D D D D D D D D D D D D D D D D D D D D D D D D D D D D D D D D D D D D D D D D D D D D D D D D D D G X X
X D D D D D D D D D D D D D D D D D D D D D D D D D D D D D D D D D D D D D D D D D D D D D D D D D D D D D D D D D D D D D D D D D D D D D D D D D G X X
X D D D D D D D D D D D D D D D D D D D D D D D D D D D D D D D D D D D D D D D D D D D D D D D D D D D D D D D D D D D D D D D D D D D D D D D D D G X X
X D D D D D D D D D D D D D D D D D D D D D D D D D D D D D D D D W W W W W W W D D D D D D D D D D D D D D D D D D D D D D D D D D D D D D D D D D G X X
X D D D D D D D D D D D D D D D D D D D D D D D D D D D D D D D W W W W W W W W W D D D D D D D D D D D D D D D D D D D D D D D D D D D D D D D D D G X X
X D D D D D D D D D D D D D D D D D D D D D D D D D D D D D D W W W W W W W W W W W W W D D D D D D D D D D D D D D D D D D D D D D D D D D D D D D G X X
X D D D D D D D D D D D D D D D D D D D D D D D D D D D D D D W W W W W W W W W W W W W W W D D D D D D D D D D D D D D D D D D D D D D D D D D D D G X X
X D D D D D D D D D D D D D D D D D D D D D D D D D D D D D D W W W W W W W W W W W W W W W D D D D D D D D D D D D D D D D D D D D D D D D D D D D G X X
X D D D D D D D D D D D D D D D D D D D D D D D D D D D D D D W W W W W W W W W W W W W W W D D D D D D D D D D D D D D D D D D D D D D D D D D D D G X X
X D D D D D D D D D D D D D D D D D D D D D D D D D D D D D D D W W W W W W W W W W W W W D D D D D D D D D D D D D D D D D D D D D D D D D D D D D G X X
X D D D D D D D D D D D D D D D D D D D D D D D D D D D D D D D W W W W W W W W W W W W D D D D D D D D D D D D D D D D D D D D D D D D D D D X X X X X X
X D D D D D D D D D D D D D D D D D D D D D D D D D D D D D D D D W W W W W W W W W D D D D D D D D D D D D D D D D D D D D D D D D D D D D D X X X X X X
X D D D D D D D D D D D D D D D D D D D D D D D D D D D D D D D D D D W W W W W D D D D D D D D D D D D D D D D D D D D D D D D D D D D D D D X X X X X X
X D D D D D D D D D D D D D D D D D D D D D D D D D D D D D D D D D D D D D D D D D D D D D D D D D D D D D D D D D D D D D D D D D D X X X X X X X X X X
X D D D D D D D D D D D D D D D D D D D D D D D D D D D D D D D D D D D D D D D D D D D D D D D D D D D D D D D D D D D D D D D D D D X X X X X X X X X X
X D D D D D D D D D D D D D D D D D D D D D D D D D D D D D D D D D D D D D D D D D D D D D D D D D D D D D D D D D D D D D D D D D D X X X X X X X X X X
X X X X X X X X X X X X X X X X X X X X X X X X X X X X X X X X X X X X X X D D X X X X X X X X X X X X X X X X X X X X X X X X X X X X X X X X X X X X X
X X X X X X X X X X X X X X X X X X X X X X X X X X X X X X X X X X X X X X X X X X X X X X X X X X X X X X X X X X X X X X X X X X X X X X X X X X X X X