B G D D D D D D D D B D D D D
G D D G G D D D D D F F D D D
D D D G G D D D D D F F D D D
D D D G D D D D D D D D D D D
D D D D D D D D D D D D D M M
D D D D D D D D D D D D M W W
D D D D D D D D D D D D M W W
B D D D D D D D D D D D M M M
D D D D D D D D D D D D D D D
D D D D D D D D D D D D D D D
D D D D M M D D D D D D D D D
D D D M W W M D D D D D D D D
D D D M W W M D D D D D D D B
D G G D M M D D D B B D D D B