B G D D D D D D D D B
G D D G D D D F F D D
D D D G D D D F F D D
D D D D D D D D D M M
D D D D D D D D M W W
B D D D D D D D M M W
D D D D D D D D D D M
D D D D M M D D D D D
D D D M W W M D D D D
D G G D M M D D D B B